libssl: libcrypto, zlib
libcrypto: libssl
zlib: 
python-requests: python-urllib3, python-certifi
python-urllib3: python-requests
python-certifi: 
nodejs: libc6, libstdc++
libc6: 
libstdc++: gcc-base
gcc-base: 
apache2: apr-utils, libexpat
apr-utils: apr
apr: 
libexpat: 
mysql-client: libmysql, libssl
libmysql: mysql-client
gcc: binutils, cpp
binutils: gcc
cpp: gcc
nginx: libpcre3, zlib, libssl
libpcre3: 
postgresql: libpq5, libssl
libpq5: 
docker: containerd, runc
containerd: runc
runc: docker
redis: libjemalloc
libjemalloc: 
mongodb: libsnappy, libssl
libsnappy: 
git: libcurl4, libexpat
libcurl4: libssl, zlib
python3: libpython3, libexpat
libpython3: 
java-runtime: libfontconfig, libc6
libfontconfig: 
maven: java-runtime
gradle: java-runtime
elasticsearch: java-runtime, systemd
systemd: 
kafka: java-runtime, zookeeper
zookeeper: java-runtime
graphql-api: nodejs, redis
rest-api: python3, postgresql
websocket-server: nodejs, redis
auth-service: libssl, postgresql
payment-gateway: auth-service, redis
notification-service: kafka, redis
webapp-frontend: nodejs, webpack
webpack: nodejs, babel
babel: webpack
typescript-compiler: nodejs
react-app: nodejs, webpack, babel
vue-app: nodejs, webpack
angular-app: nodejs, typescript-compiler
data-processor: python3, numpy
numpy: python3, libopenblas
libopenblas: 
scipy: numpy
pandas: numpy, python3
matplotlib: numpy, libfreetype
libfreetype: 
jenkins: java-runtime, git
terraform: